########### ###########
#.........###.........#
#...P.....|.|.........#
#.........###.........#
########### #######|###
                  #.#
                  #.#
                  #.#
                  #.#
                  #.#
                  #.#
                  #.#
                  #.#
                  #.#
                  #.#
                  #.#
###################|##################
#....................................#
#....................................#
#....................................#
#....................................#
#....................................#
#....................................#
#....................................#
#....................................#
#....................................#
#....................................#
######################################                